a	a	['a']
i	ai	['a', 'i']
k	aach	['a', 'a', 'k', 'h']
h	aach	['a', 'a', 'k', 'h']
e	aachen	['a', 'a', 'k', 'h', 'e', 'n']
n	aachen	['a', 'a', 'k', 'h', 'e', 'n']
l	aalenian	['a', 'a', 'l', 'e', 'n', 'i', 'j', 'a', 'n']
j	aalenian	['a', 'a', 'l', 'e', 'n', 'i', 'j', 'a', 'n']
t	aalto	['a', 'a', 'l', 't', 'o']
o	aalto	['a', 'a', 'l', 't', 'o']
r	aarau	['a', 'a', 'r', 'a', 'u']
u	aarau	['a', 'a', 'r', 'a', 'u']
g	aargau	['a', 'a', 'r', 'g', 'a', 'u']
s	aasen	['a', 'a', 's', 'e', 'n']
b	ab	['a', 'b']
m	abacteriemic	['a', 'b', 'a', 'k', 't', 'e', 'r', 'i', 'j', 'e', 'm', 'i', 'k']
a1	abacă	['a', 'b', 'a', 'k', 'a1']
d	abadan	['a', 'b', 'a', 'd', 'a', 'n']
dz1	abager	['a', 'b', 'a', 'dz1', 'e', 'r']
z1	abajur	['a', 'b', 'a', 'z1', 'u', 'r']
z	abatiză	['a', 'b', 'a', 't', 'i', 'z', 'a1']
ts	abaţial	['a', 'b', 'a', 'ts', 'i', 'a', 'l']
p	abba	['a', 'p', 'b', 'a']
v	abbevilian	['a', 'p', 'b', 'e', 'v', 'i', 'l', 'i', 'j', 'a', 'n']
ex	abbeville	['a', 'p', 'b', 'e', 'v', 'i', 'l', 'ex']
ts1	abceda	['a', 'b', 'ts1', 'e', 'd', 'a']
f	abcedografie	['a', 'b', 'ts1', 'e', 'd', 'o', 'g', 'r', 'a', 'f', 'i', 'j', 'e']
ox	aboală	['a', 'b', 'ox', 'a', 'l', 'a1']
s1	abraş	['a', 'b', 'r', 'a', 's1']
i0	aburi	['a', 'b', 'u', 'r', 'i0']
sil	acetilsalicilic	['a', 'ts1', 'e', 't', 'i', 'l', 'sil', 's', 'a', 'l', 'i', 'ts1', 'i', 'l', 'i', 'k']
a2	acoperemânt	['a', 'k', 'o', 'p', 'e', 'r', 'e', 'm', 'a2', 'n', 't']
